11111111
10000XX1
10000CC1
10000PP1
11111111
