1111111111111
1000100E01001
1001110001011
1100001101001
1001101001011
1000101000C01
1C1C10P011011
1111111111111
