10011111
00000PP1
1EE1CC10
111110111
