111111111
111111111
11C000011
110P0C011
111011011
11C01E011
111111111
111111111
111111111
100000001
111111111
